Mood (feat. iann dior)	24kGoldn
Youngblood	5 Seconds of Summer
Bi Saraha	Abeer Nehme
Ba'ad Gheyabo	Ahmed Batshan
Met3ala2 Beeky	Ahmed El Ruby
Hijaz Gar	Ahmed Germani
3la 3eny	Ahmed Kamel
Kan Fe Tefl	Ahmed Kamel
Le3btek	Ahmed Kamel
Meen Fe Dol	Ahmed Kamel
Ouly	Ahmed Kamel
Aleky Eyoun	Ahmed Saad
El Youm El Helw Dah	Ahmed Saad
Kol Youm	Ahmed Saad
Sa'alt Nafsy Keteer	Ahmed Saad
Sayrena Ya Donia	Ahmed Saad
100 Bad Days	AJR
3 O'Clock Things	AJR
Bang!	AJR
Big Idea	AJR
Birthday Party	AJR
Break My Face	AJR
Bud Like You	AJR
Bummerland	AJR
Burn the House Down	AJR
Come Hang Out	AJR
Dear Winter	AJR
Don't Throw Out My Legos	AJR
Drama	AJR
The Entertainment's Here	AJR
The Good Part	AJR
Humpty Dumpty	AJR
I'm Not Famous	AJR
I'm Ready	AJR
Infinity	AJR
Karma	AJR
Livin' on Love	AJR
My Play	AJR
Next Up Forever	AJR
No Grass Today	AJR
Normal	AJR
Ordinaryish People (feat. Blue Man Group)	AJR
Pretender - Acoustic	AJR
Role Models	AJR
Sober Up (feat. Rivers Cuomo)	AJR
Thirsty	AJR
Three-Thirty	AJR
Way Less Sad	AJR
Weak	AJR
World's Smallest Violin	AJR
Wow, I'm Not Crazy	AJR
ستو أنا	Akram Hosny
Alone, Pt. II	Alan Walker
Darkside	Alan Walker
Faded	Alan Walker
Faded	Alan Walker
Ignite	Alan Walker
1994	Alec Benjamin
Annabelle's Homework	Alec Benjamin
The Book of You & I	Alec Benjamin
Boy In The Bubble	Alec Benjamin
Death Of A Hero	Alec Benjamin
Demons	Alec Benjamin
Deniro	Alec Benjamin
Devil Doesn’t Bargain	Alec Benjamin
Dopamine Addict	Alec Benjamin
Gotta Be A Reason	Alec Benjamin
Hammers	Alec Benjamin
Hill I Will Die On	Alec Benjamin
Hipocrite	Alec Benjamin
I Built A Friend (2020)	Alec Benjamin
If I Killed Someone For You	Alec Benjamin
If We Have Each Other	Alec Benjamin
I'm Not A Cynic	Alec Benjamin
Jesus in LA	Alec Benjamin
Just Like You	Alec Benjamin
Let Me Down Slowly	Alec Benjamin
Let Me Down Slowly (feat. Alessia Cara)	Alec Benjamin
Match In The Rain	Alec Benjamin
Mind Is A Prison	Alec Benjamin
Must Have Been The Wind	Alec Benjamin
Nancy Got A Haircut	Alec Benjamin
Nuance	Alec Benjamin
Oh My God	Alec Benjamin
Older	Alec Benjamin
One Wrong Turn	Alec Benjamin
Outrunning Karma	Alec Benjamin
Shadow Of Mine	Alec Benjamin
Six Feet Apart	Alec Benjamin
Speakers	Alec Benjamin
Swim	Alec Benjamin
Water Fountain	Alec Benjamin
The Way You Felt	Alec Benjamin
Backwards	Alexander Stewart
Ahkelak	Ali Loka
Matkhafesh Yamma	Ali Loka
I Found - Acoustic	Amber Run
Best Day Of My Life	American Authors
2002	Anne-Marie
Used to Be	Arrows to Athens
Worlds Apart	Ash
On My Own	Ashes Remain
Shokran	Assala Nasri
Hey Brother	Avicii
The Nights	Avicii
Wake Me Up	Avicii
Ana Ghaltan	Bahaa Sultan
Oum O'aaf	Bahaa Sultan
Ta3ala Adalla3ak	Bahaa Sultan
Diplomacy	Balqees
Dancin' in the Aisles	Barry Manilow
Eastside (with Halsey & Khalid)	benny blanco
lovely (with Khalid)	Billie Eilish
IDGAF (with blackbear)	BoyWithUke
Toxic	BoyWithUke
Two Moons	BoyWithUke
Talking to the Moon	Bruno Mars
Angel With a Shotgun	The Cab
Moon	The Cab
Stand Up	The Cab
These Are The Lies	The Cab
No Friends	Cadmium
Aam Ghareeb	Cairokee
Akher Oghnya	Cairokee
Ana El Segara	Cairokee
Ana El Sout	Cairokee
Ana Negm	Cairokee
Basrah w Atooh	Cairokee
Benkhaf	Cairokee
Benkhaf	Cairokee
Dinosaur	Cairokee
Dinosaur	Cairokee
Edhak	Cairokee
EL Keif	Cairokee
El Seka Shemal Fe Shemal	Cairokee
El Sekka Shemal	Cairokee
Ghammad Einak	Cairokee
Hatlena Bel Ba'y Leban	Cairokee
Hatlena Bel Ba'y Leban	Cairokee
Hodna	Cairokee
James Dean	Cairokee
Kan Lak Ma'aya (Feat. Umm Kulthum)	Cairokee
Kan Lak Ma'aya (Feat. Umm Kulthum)	Cairokee
Kont Faker	Cairokee
Layla	Cairokee
Ma A'ad Sagheran	Cairokee
Marboot B Astek	Cairokee
Massraheya	Cairokee
Neaady El Sharea Sawa	Cairokee
Noaata Beida	Cairokee
Samurai	Cairokee
Sarah	Cairokee
Tarantino	Cairokee
Ya Abyad Ya Eswed	Cairokee
Ya Abyad Ya Eswed	Cairokee
Yala Neghany	Cairokee
أتجنن Etganen (Seeb Nafsak)	Cairokee
القلب اشتكى	Cairokee
الملك El Malek	Cairokee
بكره الشمس تطلع Bokra Al Shams Tetlaa	Cairokee
حلمى أنا Helmy Ana	Cairokee
لو كان عندى جيتار Law Kan Andy Guitar	Cairokee
On & On	Cartoon
Something Just Like This	The Chainsmokers
This Feeling	The Chainsmokers
Attention	Charlie Puth
Light Switch	Charlie Puth
One Call Away	Charlie Puth
We Don't Talk Anymore (feat. Selena Gomez)	Charlie Puth
I Miss You (feat. Julia Michaels)	Clean Bandit
Solo (feat. Demi Lovato)	Clean Bandit
Symphony (feat. Zara Larsson)	Clean Bandit
Hymn for the Weekend	Coldplay
Don't Let Me Down	Conor Maynard
Gangsta's Paradise	Coolio
Be Alright	Dean Lewis
Outnumbered	Dermot Kennedy
Everything	Diamond Eyes
Change My Clothes	Dream
Levitating (feat. DaBaby)	Dua Lipa
Arcade	Duncan Laurence
Arcade	Duncan Laurence
Bad Habits	Ed Sheeran
Beautiful People (feat. Khalid)	Ed Sheeran
Royalty	Egzod
Shine	Elgate feat. Spektrem
Champion	Elina
3alam Rabe3	El Joker
7elm Kbeer	El Joker
Adreen	El Joker
Akhina	El Joker
Aya	El Joker
Donia	El Joker
The Father	El Joker
Fora2 Salonat	El Joker
Kobayt El 3asir	El Joker
Mathemsh	El Joker
Qasida	El Joker
RAKAM 1 DA MESH ENTA	El Joker
Symphonia	El Joker
Tesainati	El Joker
TOTLOB AMA TOTLOB	El Joker
ياسطى	El Joker
Centuries	Fall Out Boy
Immortals	Fall Out Boy
My Songs Know What You Did In The Dark (Light Em Up)	Fall Out Boy
The Phoenix	Fall Out Boy
بأمارة مين	Farid
Break My Heart Again	FINNEAS
Break My Heart Again	FINNEAS
I Lost a Friend	FINNEAS
Fly	Fransis Derelle
The Best	Future Royalty
i hate u, i love u (feat. olivia o'brien)	gnash
The Spectacular Spider-Man Main Theme (From "The Spectacular Spider-Man")	Geek Music
Heat Waves	Glass Animals
Blood // Water	grandson
Stereo Hearts (feat. Adam Levine)	Gym Class Heroes
Without Me	Halsey
Without Me	Halsey
Watermelon Sugar	Harry Styles
Superhero	Hayd
Take Me To Church	Hozier
Come Alive	Hugh Jackman
From Now On	Hugh Jackman
The Greatest Show	Hugh Jackman
The Other Side	Hugh Jackman
Piece Of My Heart	Hussain Aljassmi
First Time	ILLENIUM
Believer	Imagine Dragons
Believer	Imagine Dragons
Bones	Imagine Dragons
Demons	Imagine Dragons
Enemy (with JID) - from the series Arcane League of Legends	Imagine Dragons
Whatever It Takes	Imagine Dragons
I'm Ready	Jaden
Can I Be Him	James Arthur
Impossible	James Arthur
Train Wreck	James Arthur
Heroes Tonight	Janji
I'll Be Good	Jaymes Young
I'll Be Good	Jaymes Young
Infinity	Jaymes Young
comethru	Jeremy Zucker
Firefly	Jim Yosef
Sucker	Jonas Brothers
Roses Are Red (Violets Are Blue)	Jon Caryl
Freaks	Jordan Clarke
Come & Go (with Marshmello)	Juice WRLD
Lucid Dreams	Juice WRLD
Invisible	Julius Dreisig
End of Time	K-391
Play	K-391
This Is Me	Keala Settle
STAY (with Justin Bieber)	The Kid LAROI
Brother	Kodaline
Gold	Koven
Not Over Yet (feat. Tom Grennan)	KSI
Now	Landon Austin
i'm so tired...	Lauv
Awaken	League of Legends
Legends Never Die	League of Legends
Phoenix	League of Legends
RISE	League of Legends
Run It	League of Legends
Take Over	League of Legends
Warriors	League of Legends
Worlds Collide	League of Legends
Betadeen	Lege-Cy
تاني	Lege-Cy
عرفة	Lege-Cy
مفيش مانع	Lege-Cy
Before You Go	Lewis Capaldi
Bruises	Lewis Capaldi
Someone You Loved	Lewis Capaldi
INDUSTRY BABY (feat. Jack Harlow)	Lil Nas X
INDUSTRY BABY (feat. Jack Harlow)	Lil Nas X
Old Town Road	Lil Nas X
STAR WALKIN' (League of Legends Worlds Anthem)	Lil Nas X
CASTLE OF GLASS	Linkin Park
Given Up	Linkin Park
In the End	Linkin Park
Numb	Linkin Park
One Step Closer	Linkin Park
Until It's Gone	Linkin Park
What I've Done	Linkin Park
What I've Done	Linkin Park
Never Enough	Loren Allred
Fearless	Lost Sky
Fearless Pt. II	Lost Sky
I'm A Monster	Lucha
7 Years	Lukas Graham
Love Someone	Lukas Graham
Love Someone	Lukas Graham
Can't Hold Us (feat. Ray Dalton)	Macklemore & Ryan Lewis
7elm B3eed	Mahmoud El Esseily
Ana El Momkn	Mahmoud El Esseily
Enta Tekdar	Mahmoud El Esseily
Beggin'	Måneskin
Uptown Funk (feat. Bruno Mars)	Mark Ronson
Cold	Maroon 5
Memories	Maroon 5
FRIENDS	Marshmello
Happier	Marshmello
OK Not To Be OK	Marshmello
In the Name of Love	Martin Garrix
Scared to Be Lonely	Martin Garrix
HUSTLE	Marwan Moussa
البوصلة ضاعت	Marwan Moussa
Sindbad	Marwan Pablo
Astronaut In The Ocean	Masked Wolf
Tightrope	Michelle Williams
Dynasty	MIIA
Everybody Gets High	MISSIO
Wasted	MKTO
Beny W Benk	Mohammed Saeed
Konty 2olely	Mohammed Saeed
Law	Mohammed Saeed
Mesh Bahke	Mohammed Saeed
Wahdy Lakn	Mohammed Saeed
Anybody Else	Moseqar
Chandelier	Moseqar
Life - Acoustic	Moseqar
Magic	Moseqar
An Albaha	Muhammad Naglah
Layla	Muhammad Naglah
Losing My Mind	Muhammad Naglah
Rush Hour	Muhammad Naglah
Etnaset	Muslim - مُسلِم
Mabahrbsh	Muslim - مُسلِم
Mesh Nadman	Muslim - مُسلِم
Best of Me	NEFFEX
Born a Rockstar	NEFFEX
Cold	NEFFEX
Destiny	NEFFEX
Fight Back	NEFFEX
Go!	NEFFEX
Grateful	NEFFEX
Life	NEFFEX
My Way	NEFFEX
Never Give Up	NEFFEX
Numb	NEFFEX
Rumors	NEFFEX
Soldier	NEFFEX
Let You Down	NF
Paralyzed	NF
10/10 (Don't Recommend)	Nico Collins
Alone	Nico Collins
Borderline	Nico Collins
Broke	Nico Collins
Head in Her Heart	Nico Collins
"Honest"	Nico Collins
It's My Bad	Nico Collins
Nothing Ever Changes	Nico Collins
Numb	Nico Collins
Our Way Out	Nico Collins
Over and over Again	Nico Collins
Top of the World	Nico Collins
Ala El Hady	Nour Khan
Light That Fire	Oh The Larceny
This Is It	Oh The Larceny
El Ahfad	Omar Ali Mahmoud
Saber,	Omar Ali Mahmoud
Afwan Ayoha El Qanoun	Omar Khairat
Fi Hawid El Leil	Omar Khairat
El Nahr El Khaled	Omar Khairat
Dameer Abla Hekmat 1	Omar Khairat
El Helm	Omar Khairat
El Shera El Maksoor	Omar Khairat
El Shera El Maksoor 2	Omar Khairat
Fee Howayd El Layl	Omar Khairat
Ghawayesh	Omar Khairat
Ghawayesh 2	Omar Khairat
Qadeyet Am Ahmed	Omar Khairat
Khali Balak Men Aklak	Omar Khairat
El Noom Fel Assal	Omar Khairat
Maloon	Omar Khairat
Ommy	Omar Khairat
Sarseb	Omar Khairat
Zay El Hawa	Omar Khairat
Zay El Hawa 1	Omar Khairat
El Sheraa El Maksour	Omar Khairat
والله ما طلعت شمس ولا غربت	Omar Khairat
Heroes of Today	Once Monsters
My Name Is..	Once Monsters
Night Changes	One Direction
Story of My Life	One Direction
Counting Stars	OneRepublic
Rescue Me	OneRepublic
From the Inside	Outrun the Fall
High Hopes	Panic! At The Disco
Circles	Post Malone
rockstar (feat. 21 Savage)	Post Malone
Sunflower - Spider-Man: Into the Spider-Verse	Post Malone
death bed (coffee for your head)	Powfu
Human	Rag'n'Bone Man
Lessa Bahinlha	Ramy Essam
Ellet El Ehsas	Ramy Gamal
Ohebuka Raghman	Rima Yussef
Your Song - Acoustic	Rita Ora
See Me Fall - Y2K Remix	Ro Ransom
These Days (feat. Jess Glynne, Macklemore & Dan Caplen)	Rudimental
These Days (feat. Jess Glynne, Macklemore & Dan Caplen)	Rudimental
If By Chance	Ruth B.
Lost Boy	Ruth B.
Lost Boy	Ruth B.
Fire On Fire - From "Watership Down"	Sam Smith
Stay With Me	Sam Smith
Unholy (feat. Kim Petras)	Sam Smith
Older	Sasha Alex Sloan
Best Part	The Score
Best Part	The Score
Born For This	The Score
Born For This	The Score
Can't Stop Me Now	The Score
Can You Hear Me Now	The Score
The Champion	The Score
Don't Wanna Be	The Score
Enemies	The Score
The Fear	The Score
Fire	The Score
Head Up	The Score
The Heat	The Score
Higher	The Score
Legend	The Score
Miracle	The Score
Money Run Low	The Score
Never Going Back	The Score
On And On	The Score
Revolution	The Score
Shakedown	The Score
Unstoppable	The Score
Flares	The Script
Hall of Fame (feat. will.i.am)	The Script
The Man Who Can't Be Moved	The Script
Superheroes	The Script
Wolves	Selena Gomez
Elvaranda	Shahyn
Ma 3aleena	Shahyn
SIRI	Shahyn
Arosty	Sharmoofers
Easy Money	Sharmoofers
Hazina	Sharmoofers
Single	Sharmoofers
مفتقد الحبيبة	Sharmoofers
Señorita	Shawn Mendes
Stitches	Shawn Mendes
There's Nothing Holdin' Me Back	Shawn Mendes
Unstoppable	Sia
7 Years (Remix)	Sik World
Eyes Blue Like The Atlantic, Pt. 2 (feat. Powfu, Alec Benjamin & Rxseboy)	Sista Prod
Love Is Gone - Acoustic	SLANDER
My Demons	STARSET
Ashes	Stellar
Bad Dream	Stellar
Blur	Stellar
El Dorado	Stellar
Cradles	Sub Urban
Glad You Came	Sun Goes Down
El Fatra Di	Tamer Ashour
Tegy Ntrahn	Tamer Ashour
Look What You Made Me Do	Taylor Swift
ME! (feat. Brendon Urie of Panic! At The Disco)	Taylor Swift
Fly Away	TheFatRat
Unity	TheFatRat
We'll Meet Again	TheFatRat
Heart of Courage	Thomas Bergersen
Little Bit of Love	Tom Grennan
Only One King	Tommee Profitt
Dance Monkey	Tones And I
Breaking Me	Topic
Falling	Trevor Daniel
Stressed Out	Twenty One Pilots
DEAD	Unknown Brain
Perfect 10	Unknown Brain
Say Goodbye	Unknown Brain
Superhero	Unknown Brain
Superhero	Unknown Brain
8 Legged Dreams	Unlike Pluto
Everything Black	Unlike Pluto
Oh Raven (Sing Me A Happy Song)	Unlike Pluto
Fire Again	VALORANT
Nevada	Vicetone
Unity	The Walkers
You're Gonna Know My Name	Watt White
البخت	Wegz
بعودة يا بلادى ( من فيلم " كباتن الزعتري ")	Wegz
Sad Song (feat. Elena Coats)	We The Kings
Sad Song (feat. Elena Coats)	We The Kings
8 Letters	Why Don't We
In Too Deep	Why Don't We
The Kindest Thing	Will Post
See You Again (feat. Charlie Puth)	Wiz Khalifa
Rewrite The Stars	Zac Efron
Rewrite The Stars	Zac Efron
Fil Sama	Zap Tharwat
Nour	Zap Tharwat
Never Forget You	Zara Larsson
Born Ready	Zayde Wølf
Cold-Blooded	Zayde Wølf
Gladiator	Zayde Wølf
Heroes	Zayde Wølf
Hustler	Zayde Wølf
Dusk Till Dawn (feat. Sia) - Radio Edit	ZAYN
A Million Dreams	Ziv Zaifman